# Базовый словарь: английское=русское

imagine=представлять
sky=небо
easy=легко
friend=друг
lover=возлюбленный
club=клуб
bar=бар
guns=оружие
fun=веселье
word=слово
if=если
you=ты
try=пытаться
no=нет
hell=ад
above=над
only=только
us=нас
look=смотри
had=имел
one=один
shot=шанс
or=или
opportunity=возможность
to=чтобы
seize=ухватиться
everything=всё
ever=когда-либо
wanted=хотел
moment=момент
would=бы
capture=захватить
it=его
just=просто
let=позволить
slip=ускользнуть
his=его
palms=ладони
are=есть
sweaty=потные
knees=колени
weak=слабые
arms=руки
heavy=тяжёлые
there's=есть
vomit=рвота
on=на
sweater=свитер
already=уже
mom's=мамин
spaghetti=спагетти
he's=он
nervous=нервный
but=но
the=этот
surface=внешне
he=он
looks=выглядит
calm=спокойный
and=и
ready=готовый